1 1 1 1 1 1 1 1 1 1 1 1 1 1 1 1 1 1 1 1 
1 4 0 0 0 0 0 0 0 0 0 0 0 0 0 0 0 0 4 1 
1 0 1 1 1 1 1 1 1 3 1 1 1 1 1 1 1 1 0 1 
1 0 1 4 0 0 0 0 0 5 0 0 0 0 0 0 4 1 0 1 
1 0 1 0 1 1 1 1 1 1 1 1 1 1 1 1 0 1 0 1 
1 0 1 0 1 4 0 0 0 5 0 0 0 0 4 1 0 1 0 1 
1 0 1 0 1 0 1 1 1 3 1 1 1 1 0 1 0 1 0 1 
1 0 1 0 1 0 1 4 0 5 0 0 4 1 0 1 0 1 0 1 
1 0 1 0 1 0 1 0 1 1 1 1 0 1 0 1 0 1 0 1 
1 0 1 0 1 0 1 0 1 0 5 3 0 1 0 3 0 1 0 3 
2 4 1 0 3 0 1 0 3 0 0 1 0 1 0 1 0 1 0 1 
1 0 1 0 1 0 1 0 1 1 1 1 0 1 0 1 0 1 0 1 
1 0 1 0 1 0 1 4 0 0 0 0 4 1 0 1 0 1 0 1 
1 0 1 0 1 0 1 1 1 1 3 1 1 1 0 1 0 1 0 1 
1 0 1 0 1 4 0 0 0 0 0 0 0 0 4 1 0 1 0 1 
1 0 1 0 1 1 1 1 1 1 1 1 1 1 1 1 0 1 0 1 
1 0 1 4 0 0 0 0 0 0 0 0 0 0 0 0 4 1 0 1 
1 0 1 1 1 1 1 1 1 1 3 1 1 1 1 1 1 1 0 1 
1 4 0 0 0 0 0 0 0 0 0 0 0 0 0 0 0 0 4 1 
1 1 1 1 1 1 1 1 1 1 1 1 1 1 1 1 1 1 1 1 